1 1 1 1 1 1 1 1 1 1 1 1 1 1 1 1 1 1 1 1 1 1 1
1 5 2 2 2 9 2 2 2 2 3 1 2 2 2 2 2 2 7 2 2 2 1
1 2 1 4 1 2 1 4 1 1 2 1 2 1 1 1 1 2 1 4 1 2 1
1 2 1 4 1 2 1 4 1 1 2 1 2 1 1 1 1 2 1 4 1 2 1
1 3 2 2 2 2 2 7 2 2 3 2 2 2 2 2 2 2 2 2 2 3 1
1 2 1 1 1 2 1 2 1 1 1 1 1 1 1 2 1 2 1 1 1 2 1
1 2 2 8 2 2 1 2 2 2 2 1 2 2 8 2 1 2 8 2 2 2 1
1 1 1 4 1 2 1 1 1 1 2 1 2 1 1 1 1 2 1 1 1 1 1
1 2 2 2 2 2 1 2 2 2 2 2 2 2 2 2 1 2 2 2 2 2 1
1 2 1 1 1 8 1 2 1 1 1 4 1 1 1 3 1 8 1 4 1 2 1
1 1 1 1 1 2 1 2 4 6 6 6 6 0 4 2 1 2 1 4 1 1 1
1 2 2 2 2 2 1 2 1 1 1 4 1 1 1 2 1 2 2 2 2 2 1
1 2 1 1 1 3 2 2 2 8 2 3 2 2 2 2 2 3 1 1 1 1 1
1 2 2 3 1 2 1 1 1 4 1 1 1 1 4 1 1 2 1 2 2 2 1
1 1 1 2 1 2 1 1 1 4 1 1 1 1 4 1 1 2 1 2 1 1 1
1 2 1 2 2 7 2 2 2 2 8 2 2 2 2 2 7 2 2 2 1 7 1
1 2 1 2 1 1 1 1 1 1 2 1 1 1 1 2 1 1 1 2 1 2 1
1 2 2 7 2 2 2 2 3 2 2 2 8 2 2 2 2 2 3 2 2 2 1
1 1 1 1 1 1 1 1 1 1 1 1 1 1 1 1 1 1 1 1 1 1 1

