1 1 1 1 1 1 1 1 1 1 1 1 1 1 1 1 1 1 1 1 1 1 1
1 3 2 2 2 2 1 2 2 2 2 8 2 2 2 2 1 2 2 2 2 3 1
1 2 1 1 1 2 1 2 1 1 1 4 1 1 1 2 1 2 1 1 1 2 1
1 2 1 3 1 8 1 2 2 2 2 7 2 2 2 2 1 8 1 3 1 2 1
1 2 1 2 1 4 1 2 1 1 1 2 1 1 1 2 1 4 1 2 1 2 1
1 2 1 2 2 2 2 2 2 2 1 2 1 2 2 2 2 2 2 2 1 2 1
1 2 1 1 1 2 1 1 1 2 1 2 1 2 1 1 1 2 1 1 1 2 1
1 2 2 2 1 2 1 2 2 2 2 3 2 2 2 2 1 2 1 2 2 2 1
1 1 1 2 1 2 1 2 1 1 1 4 1 1 1 2 1 2 1 2 1 1 1
8 0 0 2 2 7 1 2 4 0 0 6 0 0 4 2 1 7 2 2 0 0 8
1 1 1 2 1 2 1 2 1 1 1 4 1 1 1 2 1 2 1 2 1 1 1
1 2 2 2 1 2 2 2 2 2 2 3 2 2 2 2 2 2 1 2 2 2 1
1 2 1 1 1 2 1 1 1 1 2 1 2 1 1 1 1 2 1 1 1 2 1
1 2 1 8 2 2 2 2 1 0 0 8 0 0 1 2 2 2 2 8 1 2 1
1 2 1 2 1 1 1 2 1 0 1 1 1 0 1 2 1 1 1 2 1 2 1
1 2 2 2 2 2 2 3 1 0 0 9 0 0 1 3 2 2 2 2 2 2 1
1 2 1 1 1 1 1 1 1 1 1 4 1 1 1 1 1 1 1 1 1 2 1
1 2 2 2 2 2 2 2 2 8 2 5 2 8 2 2 2 2 2 2 2 2 1
1 1 1 1 1 1 1 1 1 1 1 1 1 1 1 1 1 1 1 1 1 1 1